2221222221
2  1   1 1
21  1    3
2     1  1
21   2 3 3
2   13   3
2 2   13 3
2  2  1  3
2 1    1 3
2222222111