1231231321
1  1   1 1
21  2    3
2     3  1
11   2 1 3
3   13   1
3 3   13 2
3  2  2  1
1 1    2 2
2221233111